HAT TRICK LEVEL BLUEPRINT - 13x9
BLOCK FORMAT: X:dx,dy:#ActsBeforeReversing (Ex. X:-3,3:5)

O O O O O O O O O
O O O O O O O O O
X:2,0:20 X:2,0:20 X:2,0:20 O O O X:-2,0:20 X:-2,0:20 X:-2,0:20
O O O O O O O O O
O O O O O O O O O
O O O O X O O O O
O O O O X O O O O
O O O O X O O O O
O O O O O O O O O
O X:0,-1:20 O O O O O X:0,-1:20 O
O X O O O O O X O
O X:0,1:20 O O O O O X:0,1:20 O
O O O O O O O O O

END

O O O O O O O O O
O O O O O O O O O
X X X O O O X X X
O O O O O O O O O
O O O O O O O O O
O O O O X O O O O
O O O O X O O O O
O O O O X O O O O
O O O O O O O O O
O X O O O O O X O
O X O O O O O X O
O X O O O O O X O
O O O O O O O O O
