HAT TRICK LEVEL BLUEPRINT - 13x9
BLOCK FORMAT: X:dx,dy:#ActsBeforeReversing (Ex. X:-3,3:5)

O X X O O O X X O
X X O O O O O X X
X O O O O O O O X
X O X:2,0:80 O O O O O X
X O O O O O O O X
X O O O O O X:-2,0:80 O X
X O O O O O O O X
X O X:2,0:80 O O O O O X
X O O O O O O O X
X O O O O O X:-2,0:80 O X
X O O O O O O O X
X O O O O O O O X
O O O O O O O O O

END

O X X O O O X X O
X X O O O O O X X
X O O O O O O O X
X O X O O O O O X
X O O O O O O O X
X O O O O O X O X
X O O O O O O O X
X O X O O O O O X
X O O O O O O O X
X O O O O O X O X
X O O O O O O O X
X O O O O O O O X
O O O O O O O O O