HAT TRICK LEVEL BLUEPRINT - 13x9
BLOCK FORMAT: X:dx,dy:#ActsBeforeReversing (Ex. X:-3,3:5)

X X X O O O X X X
X X O O O O O X X
X O X:1,1:50 O O O X:-1,1:50 O X
X O O O O O O O X
X X O O O O O X X
X X O O O O O X X
O O O O O O O O O
O O O O O O O O O
O X:2,0:60 O O O O O X:-2,0:60 O
X X:2,0:60 X:2,0:60 O O O X:-2,0:60 X:-2,0:60 X
X O O O O O O O X
X O O O O O O O X
X O O O O O O O X

END

X X X O O O X X X
X X O O O O O X X
X O X O O O X O X
X O O O O O O O X
X X O O O O O X X
X X O O O O O X X
O O O O O O O O O
O O O O O O O O O
O X O O O O O X O
X X X O O O X X X
X O O O O O O O X
X O O O O O O O X
X O O O O O O O X