HAT TRICK LEVEL BLUEPRINT - 13x9
BLOCK FORMAT: X:dx,dy:#ActsBeforeReversing (Ex. X:-3,3:5)

X X X O O O X X X
X X X O O O X X X
X X O O X:0,2:40 O O X X
X O O O O O O X X
X O O O O O O O X
X O O O O O O O X
X O O X:-1,0:50 X X:1,0:50 O O X
X O O O O O O O X
X O O O O O O O X
X X X O O O X X X
X X X O O O X X X
X O O O O O O O X
X O O O O O O O X

END

X X X O O O X X X
X X X O O O X X X
X X O O X O O X X
X O O O O O O X X
X O O O O O O O X
X O O O O O O O X
X O O X X X O O X
X O O O O O O O X
X O O O O O O O X
X X X O O O X X X
X X X O O O X X X
X O O O O O O O X
X O O O O O O O X